A . . # . . .
. # . . . # .
. . . . . # .
. . . # # . B
# # . . . . .
